SO ./textures/bluestone.xpm
NO ./textures/wood.xpm
WE ./textures/redbrick.xpm
EA ./textures/mossy.xpm

F 0,204,0
C 102,255,255

111111111111111111111111
100010000100000000000111
110000010101000000001001
110000010100000000000001
11000000000000100W000101
110000001100000000000001
100000100000100000001001
100000111000000000000001
111111111111111111111111