SO ./textures/bluestone.xpm
NO ./textures/redbrick.xpm
WE ./textures/wood.xpm
EA ./textures/mossy.xpm

F 0,0,250
C 255,0 ,0


  11111
1111111
 10W111  111
1111111  111
1111111  111
