SO ./textures/bluestone.xpm
NO ./textures/redbrick.xpm
WE ./textures/wood.xpm
EA ./textures/mossy.xpm

F 0,0,250
C 255,0 ,0


 11111111111111111111111
111110000100000000000111
1100000101010S0000001001
100001010100000111000001
100000000100000010000001
100000111100000011000001
100000100000000001000001
100000111000000001100001
111111111111111111111111
